7
11
WWWWWWWWWWW
W...W.W...W
W.W.W.W.WWW
W.W.......W
W.WWWW.WW.W
W.W.....WXW
WWWWWWWWWWW